8 12
.. .. NK NK YR 10 YR AR AR AR 30 31
XX XX XX XX XX XX XX XX XX XX XX 33
XX XX .. .. RR RR GG 23 .. 20 XX PP
XX XX .. XX XX XX XX XX XX .. XX PP
XX XX .. .. .. .. .. .. .. 21 R1 PP
XX XX XX XX XX XX XX XX XX XX XX 31
YR YR AR AR AR YR 00 YR AR AR 32 33
XX XX XX XX XX XX XX XX XX XX XX XX